000000030
000000330
000003330
000433334
000333330
003333330
033333330