000000010
000000110
000001110
000411114
000111110
001111110
011111110