000000020
000000220
000002220
000422224
000222220
002222220
022222220